Art	paint painter sculpter sculptur sculptor draw drawn photo photograph photo photography oils sketch art etching pictorial watercolor watercolorist camera									
Biological%20Science	botany bioscience biology biological animal genetics DNA genes cancer evolution evolutionary Darwin vertibrate inveritibrate microbiology microorganisms zoology ocean oceanographic									
Business	business entrepreneur mergers finance marketing management CEO CFO banking 									
Civil%20Rights%20&%20Social%20Justice	ACLU poverty anti-poverty wealth inequality court courthouse courtroom segregration desegration black hispanic disadvantaged disabled disabilities humanitarian incarcerated journalist law lawyer African-American of-color FBI homeless									
Climate%20Change%20&%20Ecology	cumulus green grid fracking gas car transportation desalination gasoline climate ecology ecologist									
Computer%20science	Fortran computer programming computer computation calculation computer-aided  email informatics processor Windows Macintosh iPad iPhone microcomputers									
Economics	bank banker bankruptcy industrial industry investment investor socioeconomics economist economics economic antitrust tax									
Film	Film movies cinema 									
French	French France Paris franco 									
German	German Germany germanic									
Government%20&%20Politics	Politics political congress law constitution policy democratic democratization republic Fed finance financial government governmental governor Washington law lawyer law-related  FBI 									
HILR%20Curriculum	seminar teach teacher study-group study instructor curriculum 									
History	English European USA US Irish fascism Vietnam Vietnamese Greek Hispanic Cuba Cuban Cancun War Korea revolution ancient									
Italian	Italian Italy Rome Venice Florence Milan									
Literature	literature novel story Shakespeare shakespearean Proust poet poetry victorian France French Spanish Spain Hispanic English									
Medicine	anesthesia anesthetic anti-depressants medicine medication doctor MD endocrine endodonic endodontist hemphilia hemorrhagic infection infectious infertility infirmity neural neurology neurologist neuroscientist oncology oncologist ophthalmic ophthalmology optometry optometric pathology pathologist pediatrics pediatrician pharmaceutical pharmacology physician psychiatric psychiatry psychiatrist psychoanalyst psychological psychologist psychotherapist radiology radiologist toxicology physiology health healthcare health drug									
Music	cello cellist violin piano Beethoven Bach quartets sonata orchestra choir corale clarinetist concert harp harpsichord flute clarinet trumpet singing singer zydeco lyric-coloratura rock-and guitar ukulele 									
Philosophy	philosophy philosophers religious									
Physical%20Science	astronomy astronaut aerospace physic physicist chemistry science genetics DNA gene chemical cryogenics electro electro-optics georogy mathematics math gyroscope mathematician microwave planetarium space spacecraft statistics statistician telescope philology									
Religion	atheist atheism Catholic Protestant Jewish Zen Buddhist Buddhism Muslim Jewish-American Christian Islam Islamist									
Social%20Science	anthropology cognitive community communication human socioeconomic sociology sociologist archaeology archaeologist linguistics 									
Spanish	Yucatan Spanish Spain Hispanic									
Sports	cross-country ski tennis baseball football soccer basketball hockey running Olympics									
Technology	aeronaut engineer electrical electronic transistor computer rocket technology 									
Theatre	Theatre theater actor act stage performance coreographer									
Travel	Asia Pacific Mountain Europe France Germany England Galopagos China Japan Cuba Spain Mexico Brazil Chile Tuscany turkey turkish tunisia tunis tunisian Italy Italian Holland Ireland Irish Africa travel									
Writing	write writer written									
